Abstract - Theoretical
Abstruse - Incomprehensible
Arduous	- Difficult
Baffling - Mistify
Confined - Limited
Austere - Strict
Competence - Capability
Parochial - Conservative
Moribund - Inactive
Ineptitude - Inability
Bystander - Observer
Entrench - Establish
Comprehensive - Extensive
Contagion - Infection
Cohort - Partner
Ploy - Tactic
Idiosyncrasy - Mannerism
Quibble - Criticism
Aghast - Horrified
Accrue - Collect
Synergy - Collaboration
Dash - Frustrate
Outcry - commotion
Progenitor - Founder
Sumptuous - Lavish
Enthuse - Motivate
Underscore - Stress
Sanguine - Hopeful
Fable - Story
Protectionist - Defensor 
Remit - Orbit 
Slack - Inactive
Polemics- Debate
Sully - Stain
Salience - Distinction
Totter - Insecure
Reckon- Compute
Cataclysmic - Disastrous
Unflinching - Resolute
Goliath - Titan
Mangled - Crushing
Febrile - Nervous
Connote - Recommend
Serpentine - Twisting
Heyday - Prime
Fret - Worry 
Inkling - Glimmering
Dark - Shadowy
Decide - Determine
Definite - Certain
Delicious - Savoury
Describe - Portray
Destroy - Ruin
Difference - Disagreement
Do - Execute
Eager - Keen
End	- Stop
Enjoy - Appreciate
Explain - Elaborate
Fair - Just
Fall - Drop
False - Fake
Fast - Quick
Fat	- Stout
Fear - Fright
Fly - Soar
Funny - Humorous
Get - Acquire
Go - Recede
Good - Excellent
Great - Noteworthy
Gross - Improper
Happy - Pleased
Hate - Despise
Have - Acquire
Help - Aid
Hide - Conceal
Hurry - Hasten
Hurt - Damage
Idea - Thought
Important - Necessary
Interesting	- Fascinating
Keep - Hold
Kill - Slay
Laugh - Chuckle
Lots - Quantities	
Label - Trademark
Landfill - Junkyard
Landlord - Owner
Language - Dialect
Machine	- Gadget
Mail - Letters
Major - Considerable
Malice - Bitterness
Management - Administration
Manufacture	- Construct
Nation - Country
Near - Adjacent
Nearly - Closely
Objective - Purpose
